#####################
#       #   #       #
# ### # # # # # ### #
#     #   #   #     #
# ### ### # ### ### #
# #       #       # #
# #  ## ##### ##  # #
#                   #
# ### # ## ## # ### #
#     # #   # #     #
# ### # #   # # ### #
#     # ##### #     #
# ### #       # ### #
#   # # ##### # #   #
##  #     #     #  ##
    # ### # ### #    
# ### #       # ### #
#     #   #   #     #
# # ### # # # ### # #
# #     #   #     # #
# ##### ##### ##### #
#                   #
#####################
